NO ./texture/wall1.xpm

SO ./texture/wall1.xpm

WE ./texture/wall2.xpm

EA ./texture/wall2.xpm

F 0,0,0

C 100,105,104

11111111111111111111
10000000000000000001
10000000000000000001
10000000000000000001
10000000000000000001
10000000000000000001
10000000000000000001
10000000000000000001
10000000000000000001
10000000000000000001
10000000000000000001
100000000000000000N1
11111111111111111111