NO ./texture/NO.xpm

SO ./texture/SO.xpm

WE ./texture/WE.xpm

EA ./texture/EA.xpm

F 0,0,0

C 100,105,104

11111111111111111111
10000000000000000001
10000000000000000001
10000000000000000001
10000000000000000001
10000000000000000001
10000000000000000001
10000000000000000001
10000000000000000001
10000000000000000001
10000000000000000001
10000000000N00000001
11111111111111111111